222222222222222222222222222222222222222222222
222222222222222222222222222222222222222222222
220000000000000000000000000000000000000000022
220333333333333333333333333333333333333333022
220300000000000000000000000000000000000003022
220303333333333333333333333333333333333303022
220303000000000000000000000000000000000303022
220303033333333333333333333333333333330303022
220303030000000000000000000000000000030303022
220303030333333333333333333333333333030303022
220303030300000000000000000000000003030303022
220303030303333333333333333333333303030303022
220303030303000000000000000000000303030303022
220303030303033333333333333333330303030303022
220303030303030000000000000000030303030303022
220303030303030333333333333333030303030303022
220303030303030300000000000003030303030303022
220303030303030303333333333303030303030303022
220303030303030303000000000303030303030303022
220303030303030303033333330303030303030303022
220303030303030303030000030303030303030303022
220303030303030303030333030303030303030303022
220303030303030303030303030303030303030303022
220303030303030303030303030303030303030303022
220303030303030303030303030303030303030303022
220303030303030303030303030303030303030303022
220303030303030303030303030303030303030303022
220303030303030303030303030303030303030303022
220303030303030303030303030303030303030303022
220303030303030303030303030303030303030303022
220303030303030303030303030303030303030303022
220303030303030303030303030303030303030303022
220303030303030303030303030303030303030303022
22033333333333333333333333333333333333333333022
2200000000000000000000000000000000000000000022
2203333333333333333333333333333333333333333022
22036666663036666663033333333333333333333333022
22036666663036666663000000000000000000000003022
2203333333333333333333333333333333333333333022
2222222222222222222222222222222222222222222222